"filename", "language", "Markdown", "Oracle-SQL and PLSQL", "comment", "blank", "total"
"d:\data_dapin_program\.history\PKG_ITEM_COUNT_BILI\BODY\PKG_ITEM_COUNT_BILI_20221129165809.plsql", "Oracle-SQL and PLSQL", 0, 36, 13, 5, 54
"d:\data_dapin_program\.history\PKG_ITEM_COUNT_BILI\BODY\PKG_ITEM_COUNT_BILI_20221204102604.plsql", "Oracle-SQL and PLSQL", 0, 36, 13, 5, 54
"d:\data_dapin_program\.history\PKG_ITEM_COUNT_FAC\BODY\PKG_ITEM_COUNT_FAC_20221204110938.sql", "Oracle-SQL and PLSQL", 0, 987, 66, 14, 1067
"d:\data_dapin_program\.history\PKG_ITEM_COUNT_PROCESS\BODY\PKG_ITEM_COUNT_PROCESS_20221129165721.plsql", "Oracle-SQL and PLSQL", 0, 461, 28, 4, 493
"d:\data_dapin_program\.history\PKG_ITEM_COUNT_PROCESS\BODY\PKG_ITEM_COUNT_PROCESS_20221204105854.plsql", "Oracle-SQL and PLSQL", 0, 194, 296, 4, 494
"d:\data_dapin_program\.history\PKG_ITEM_COUNT_PROCESS\BODY\PKG_ITEM_COUNT_PROCESS_20221204105916.plsql", "Oracle-SQL and PLSQL", 0, 194, 296, 4, 494
"d:\data_dapin_program\.history\PKG_ITEM_COUNT_TOOL\BODY\PKG_ITEM_COUNT_TOOL_20221129161601.plsql", "Oracle-SQL and PLSQL", 0, 388, 63, 85, 536
"d:\data_dapin_program\.history\PKG_ITEM_COUNT_TOOL\BODY\PKG_ITEM_COUNT_TOOL_20221204110207.plsql", "Oracle-SQL and PLSQL", 0, 388, 63, 85, 536
"d:\data_dapin_program\.history\PKG_ITEM_COUNT_TOOL\SPECIFICATIONS\PKG_ITEM_COUNT_TOOL_20221129161551.plsql", "Oracle-SQL and PLSQL", 0, 27, 3, 4, 34
"d:\data_dapin_program\.history\PKG_ITEM_COUNT_TOOL\SPECIFICATIONS\PKG_ITEM_COUNT_TOOL_20221204110240.plsql", "Oracle-SQL and PLSQL", 0, 27, 3, 4, 34
"d:\data_dapin_program\.history\PKG_ITEM_COUNT_ZCFZ\BODY\PKG_ITEM_COUNT_ZCFZ_20221129160429.plsql", "Oracle-SQL and PLSQL", 0, 674, 70, 44, 788
"d:\data_dapin_program\.history\PKG_ITEM_COUNT_ZCFZ\BODY\PKG_ITEM_COUNT_ZCFZ_20221204110701.plsql", "Oracle-SQL and PLSQL", 0, 674, 70, 44, 788
"d:\data_dapin_program\PKG_ITEM_COUNT_PROCESS\BODY\PKG_ITEM_COUNT_PROCESS.plsql", "Oracle-SQL and PLSQL", 0, -267, 268, 0, 1
"d:\data_dapin_program\README.md", "Markdown", 1, 0, 0, 1, 2
"d:\data_dapin_program\执行流程.sql", "Oracle-SQL and PLSQL", 0, -24, -17, -4, -45
"d:\data_dapin_program\折算以及币种维度汇总.sql", "Oracle-SQL and PLSQL", 0, -316, -47, -8, -371
"d:\data_dapin_program\机构科目汇总.sql", "Oracle-SQL and PLSQL", 0, -357, -7, -2, -366
"d:\data_dapin_program\计税.sql", "Oracle-SQL and PLSQL", 0, -309, -12, -3, -324
"Total", "-", 1, 2813, 1169, 286, 4269